Mia	W
Hannah	W
Hanna	W
Leoni	W
Leonie	W
Lena	W	
Lea	W
Leah	W
Anna	W
Emma	W
Emily	W	
Emilie	W
Marie	W
Lilli	W
Lilly	W
Lili	W
Sarah	W
Sara	W
Lara	W
Laura	W
Sophie	W
Sofie	W
Sophia	W
Sofia	W
Lina	W
Nele	W
Neele	W
Johanna	W
Maja	W
Maya	W
Amelie	W
Amely	W
Leon	W
Lucas	M
Lukas	M
Jonas	M
Luca	M
Luka	M
Paul	M
Felix	M
Maximilian	M
Finn	M
Fynn	M
Tim	M
Timm	M
Ben	M
Luis	M
Louis	M
Max	M
Julian	M
Elias	M
Niclas	M
Niklas	M
Noah	M
Jan	M
Philip	M
Philipp	M
Phillip	M
Moritz	M
Jannik	M
Yannick	M
Yannik 	M